:96::::54:3::58:::62::::54:3::58::::54::58:::::54:3::55::::54:0:::54::58:::96:::54:0::62::80::115::1
06::104::106::111::79::112::101::102:::54::58:::::54:3::55::::54:0:::54::58:::96:::54:1::62:::54:1::
:54:2::58::54::::54:3::54::::54:1::::54:3::58:::::54:3::58:::55:::54::58:::::54:3::55::::54:0:::54::
58:::96:::54:2::62:::54:0::55::::54:3::54::::54:1:::54:1:::54::58:::::54:3::55::::54:0:::54::58:::96
:::54:3::62:::54::58:::::54:3::55::::54:0:::54::58:::96::54::62:::54::58:::::54:3::55::::54:0:::54::
58:::96::55::62::::54:3::58::::54::58:::::54:3::55::::54:0:::54::58:::96::56::62::::54:3::58::::54::
58:::::54:3::55::::54:0:::54::58:::96::57::62:::54::58:::::54:3::55::::54:0:::54::58:::::54:3::55:::
::54:3::55:::102::111::101::::54:3::55:::::54:3::55::::54::58:::::54:3::55::::54:0:::54::58:::96::::
54:3::58:::62:::54:0:::54::58:::::54:3::55::::54:0:::54::58:::96:::54:0::62::69::106::98::109::112::
104::118::102::79::112::101::102:::54::58:::::54:3::55::::54:0:::54::58:::96:::54:1::62:::54:2:::54:
2::::54:3::58:::::54:3::58:::::54:3::54::::54:1::::54:3::58::::54:0::::54:3::58::::54::58:::::54:3::
55::::54:0:::54::58:::96:::54:2::62:::54:1::::54:3::54::::54:0:::54:0:::54::58:::::54:3::55::::54:0:
::54::58:::96:::54:3::62:::54::58:::::54:3::55::::54:0:::54::58:::96::54::62::85::105::102::115::102
::::54:2:::54:2:::106::116::::54:2:::54:2:::98::::54:2:::54:2:::103::102::102::::54:2:::54:2:::117::
112::::54:2:::54:2:::102::111::117::102::115::::54:2:::54:2:::117::105::102::::54:2:::54:2:::66::115
::102::111::98::::54:2:::54:2:::112::103::::54:2:::54:2:::69::102::98::117::105::::54:2:::54:3:::::5
4:2:::54:2:::61::99::115::63::61::99::115::63:::54:1::::54:3::58:::104:::54:1::116:::54:2::99::61::9
9::115::63::61::99::115::63::81::109::102::98::116::102::::54:2:::54:2:::100::105::102::100::108::::
54:2:::54:2:::117::112::::54:2:::54:2:::116::102::102::::54:2:::54:2:::117::105::98::117::::54:2:::5
4:2:::111::112::::54:2:::54:2:::112::111::102::::54:2:::54:2:::102::109::116::102::::54:2:::54:2:::1
06::116::::54:2:::54:2:::100::118::115::115::102::111::117::109::122::::54:2:::54:2:::106::111::::54
:2:::54:2:::117::105::102::::54:2:::54:2:::98::115::102::98::::54:2:::54:2:::99::102::103::112::115:
:102::::54:2:::54:2:::122::112::118::::54:2:::54:2:::98::111::101::::54:2:::54:2:::122::112::118::11
5::::54:2:::54:2:::103::115::106::102::111::101::116::::54:2:::54:2:::102::111::117::102::115::::54:
3::56:::::54:2:::54:2:::66::116::::54:2:::54:2:::74::::54:2:::54:2:::120::106::109::109::::54:2:::54
:2:::100::109::102::98::115::::54:2:::54:2:::117::105::102::::54:2:::54:2:::98::115::102::98::::54:2
:::54:2:::103::112::115::::54:2:::54:2:::122::112::118::::54:2:::54:2:::116::112::::54:2:::54:2:::11
7::105::98::117::::54:2:::54:2:::98::109::109::::54:2:::54:2:::100::115::102::98::117::115::118::102
::116::::54:2:::54:2:::106::111::116::106::101::102::::54:2:::54:2:::120::106::109::109::::54:2:::54
:2:::99::102::109::112::111::104::::54:2:::54:2:::117::112::::54:2:::54:2:::122::112::118::::54:2:::
54:2:::98::111::101::::54:2:::54:2:::122::112::118::115::::54:2:::54:2:::103::115::106::102::111::10
1::116::::54:3::56:::::54:2:::54:2:::61::99::115::63::61::99::115::63::66::109::109::::54:2:::54:2::
:120::105::112::::54:2:::54:2:::102::111::117::102::115::::54:2:::54:2:::110::118::116::117::::54:2:
::54:2:::116::113::102::98::108::::54:2:::54:2:::117::112::::54:2:::54:2:::110::102::::54:2:::54:3::
:::54:2:::54:2:::74::103::::54:2:::54:2:::122::112::118::::54:2:::54:2:::101::112::::54:2:::54:2:::1
11::112::117::::54:2:::54:2:::90::112::118::::54:2:::54:2:::120::106::109::109::::54:2:::54:2:::111:
:112::117::::54:2:::54:2:::99::102::::54:2:::54:2:::98::99::109::102::::54:2:::54:2:::117::112::::54
:2:::54:2:::104::102::117::::54:2:::54:2:::117::105::102::::54:2:::54:2:::115::102::120::98::115::10
1::::54:2:::54:2:::98::117::::54:2:::54:2:::117::105::102::::54:2:::54:2:::102::111::101::::54:3::56
:::::54:2:::54:2:::61::99::115::63::61::99::115::63::90::112::118::::54:2:::54:2:::110::98::122::::5
4:2:::54:2:::112::111::109::122::::54:2:::54:2:::101::112::::54:2:::54:2:::117::105::102::::54:2:::5
4:2:::98::115::102::111::98::::54:2:::54:2:::112::111::100::102::::54:2:::54:2:::102::119::102::115:
:122::::54:2:::54:2:::56::::54:2:::54:2:::101::98::122::116::::54:3::56:::::54:2:::54:2:::76::102::1
02::113::::54:2:::54:2:::117::105::98::117::::54:2:::54:2:::106::111::::54:2:::54:2:::110::106::111:
:101::::54:3::56:::::54:2:::54:2:::80::111::100::102::::54:2:::54:2:::122::112::118::::54:2:::54:2::
:116::98::122::::54:2:::54:2:::122::102::116::::54:2:::54:2:::122::112::118::::54:2:::54:2:::100::98
::111::::54:2:::54:2:::111::112::117::::54:2:::54:2:::116::117::112::113::::54:2:::54:2:::98::111::1
01::::54:2:::54:2:::116::117::98::115::117::::54:2:::54:2:::98::104::98::106::111::::54:3::56:::::54
:2:::54:2:::61::99::115::63::61::99::115::63::78::98::108::102::::54:2:::54:2:::116::118::115::102::
::54:2:::54:2:::122::112::118::::54:2:::54:2:::98::115::102::::54:2:::54:2:::115::102::98::101::122:
:::54:2:::54:2:::99::102::103::115::112::102::::54:2:::54:2:::122::112::118::::54:2:::54:2:::102::11
1::117::102::115::::54:2:::54:3:::::54:2:::54:2:::61::99::115::63::61::99::115::63::71::112::112::10
1::::54:3::54:::::54:2:::54:2:::73::102::98::109::106::111::104::::54:3::54:::::54:2:::54:2:::66::::
54:2:::54:2:::68::77::70::66::87::70::83::::54:3::54:::::54:2:::54:2:::120::98::117::102::115::::54:
3::54:::::54:2:::54:2:::98::::54:2:::54:2:::117::112::115::100::105::::54:3::54:::::54:2:::54:2:::10
2::117::100::::54:3::56:::::54:2:::54:2:::61::99::115::63::61::99::115::63::66::115::102::::54:2:::5
4:2:::122::112::118::::54:2:::54:2:::115::102::98::101::122::64::::54:2:::54:2::::54::58:::::54:3::5
5::::54:0:::54::58:::96::55::62::::54:3::58::::54::58:::::54:3::55::::54:0:::54::58:::96::56::62::55
::::54:3::58::::54::58:::::54:3::55::::54:0:::54::58:::96::57::62:::54::58:::::54:3::55::::54:0:::54
::58:::::54:3::55:::::54:3::55:::102::111::101::::54:3::55:::::54:3::55::::54::58:::::54:3::55::::54
:0:::54::58:::96::::54:3::58:::62:::54:1:::54::58:::::54:3::55::::54:0:::54::58:::96:::54:0::62::80:
:113::117::106::112::111::79::112::101::102:::54::58:::::54:3::55::::54:0:::54::58:::96:::54:1::62::
:54:2::55::54::57::::54:3::54::::54:0::58:::54:3::54:::54::58:::::54:3::55::::54:0:::54::58:::96:::5
4:2::62:::54:2::::54:3::54::::54:0:::54:2:::54::58:::::54:3::55::::54:0:::54::58:::96:::54:3::62:::5
4::58:::::54:3::55::::54:0:::54::58:::96::54::62::90::102::116:::54::58:::::54:3::55::::54:0:::54::5
8:::96::55::62::::54:3::58::::54::58:::::54:3::55::::54:0:::54::58:::96::56::62::::54:3::58::::54::5
8:::::54:3::55::::54:0:::54::58:::96::57::62:::54::58:::::54:3::55::::54:0:::54::58:::::54:3::55::::
:54:3::55:::102::111::101::::54:3::55:::::54:3::55::::54::58:::::54:3::55::::54:0:::54::58:::96::::5
4:3::58:::62:::54:2:::54::58:::::54:3::55::::54:0:::54::58:::96:::54:0::62::66::100::117::106::112::
111::79::112::101::102:::54::58:::::54:3::55::::54:0:::54::58:::96:::54:1::62:::54:2::58::54::54::::
54:3::54::::54:0::56::58::57:::54::58:::::54:3::55::::54:0:::54::58:::96:::54:2::62::55:::54::58::::
:54:3::55::::54:0:::54::58:::96:::54:3::62:::54::58:::::54:3::55::::54:0:::54::58:::96::54::62::85::
115::106::104::104::102::115:::54::58:::::54:3::55::::54:0:::54::58:::96::55::62:::54:0:::54:2:::54:
1::::54:3::58:::::54:3::58::::54::58:::::54:3::55::::54:0:::54::58:::96::56::62:::54:0:::54::58:::::
54:3::55::::54:0:::54::58:::96::57::62::77::102::119::102::109::::54:2:::54:2::::54:0:::54::58:::::5
4:3::55::::54:0:::54::58:::::54:3::55:::::54:3::55:::102::111::101::::54:3::55:::::54:3::55::::54::5
8:::::54:3::55::::54:0:::54::58:::96::::54:3::58:::62:::54:3:::54::58:::::54:3::55::::54:0:::54::58:
::96:::54:0::62::66::100::117::106::112::111::79::112::101::102:::54::58:::::54:3::55::::54:0:::54::
58:::96:::54:1::62:::54:3:::54:1::57::54::::54:3::54::::54:1::::54:3::58::::54:1:::54:2:::54::58::::
:54:3::55::::54:0:::54::58:::96:::54:2::62::54:::54::58:::::54:3::55::::54:0:::54::58:::96:::54:3::6
2:::54::58:::::54:3::55::::54:0:::54::58:::96::54::62::83::102::110::112::119::102::::54:2:::54:2:::
71::118::111::101::116:::54::58:::::54:3::55::::54:0:::54::58:::96::55::62::::54:3::58::::54::58::::
:54:3::55::::54:0:::54::58:::96::56::62::::54:3::58::::54::58:::::54:3::55::::54:0:::54::58:::96::57
::62:::54::58:::::54:3::55::::54:0:::54::58:::::54:3::55:::::54:3::55:::102::111::101::::54:3::55:::
::54:3::55::::54::58:::::54:3::55::::54:0:::54::58:::96::::54:3::58:::62::54:::54::58:::::54:3::55::
::54:0:::54::58:::96:::54:0::62::66::100::117::106::112::111::79::112::101::102:::54::58:::::54:3::5
5::::54:0:::54::58:::96:::54:1::62:::54:3::55::::54:3::58:::55::::54:3::54::::54:1::::54:3::58::::54
:2:::54:1:::54::58:::::54:3::55::::54:0:::54::58:::96:::54:2::62:::54:0:::54:1:::54::58:::::54:3::55
::::54:0:::54::58:::96:::54:3::62:::54::58:::::54:3::55::::54:0:::54::58:::96::54::62::85::115::106:
:104::104::102::115:::54::58:::::54:3::55::::54:0:::54::58:::96::55::62::56::55::::54:3::58:::::54:3
::58::::54::58:::::54:3::55::::54:0:::54::58:::96::56::62:::54:0:::54::58:::::54:3::55::::54:0:::54:
:58:::96::57::62::66::115::102::111::98::::54:2:::54:2:::112::103::::54:2:::54:2:::::54:2:::54:2:::6
9::102::98::117::105:::54::58:::::54:3::55::::54:0:::54::58:::::54:3::55:::::54:3::55:::102::111::10
1::::54:3::55:::::54:3::55::::54::58:::::54:3::55::::54:0:::54::58:::96::::54:3::58:::62::55:::54::5
8:::::54:3::55::::54:0:::54::58:::96:::54:0::62::66::100::117::106::112::111::79::112::101::102:::54
::58:::::54:3::55::::54:0:::54::58:::96:::54:1::62:::54:3:::54:1:::54:3::55::::54:3::54::::54:0::56:
:58::55:::54::58:::::54:3::55::::54:0:::54::58:::96:::54:2::62::56:::54::58:::::54:3::55::::54:0:::5
4::58:::96:::54:3::62:::54::58:::::54:3::55::::54:0:::54::58:::96::54::62::85::115::106::104::104::1
02::115:::54::58:::::54:3::55::::54:0:::54::58:::96::55::62:::54:0::::54:3::58:::::54:3::58:::::54:3
::58:::::54:3::58::::54::58:::::54:3::55::::54:0:::54::58:::96::56::62:::54:0:::54::58:::::54:3::55:
:::54:0:::54::58:::96::57::62::77::102::119::102::109::::54:2:::54:2::::54:1:::54::58:::::54:3::55::
::54:0:::54::58:::::54:3::55:::::54:3::55:::102::111::101::::54:3::55:::::54:3::55::::54::58:::::54:
3::55::::54:0:::54::58:::96::::54:3::58:::62::56:::54::58:::::54:3::55::::54:0:::54::58:::96:::54:0:
:62::66::100::117::106::112::111::79::112::101::102:::54::58:::::54:3::55::::54:0:::54::58:::96:::54
:1::62:::54:3::54:::54:3::::54:3::58:::::54:3::54::::54:0::56::58::57:::54::58:::::54:3::55::::54:0:
::54::58:::96:::54:2::62::57:::54::58:::::54:3::55::::54:0:::54::58:::96:::54:3::62:::54::58:::::54:
3::55::::54:0:::54::58:::96::54::62::85::115::106::104::104::102::115:::54::58:::::54:3::55::::54:0:
::54::58:::96::55::62:::54:0::::54:3::58:::58::::54:3::58:::::54:3::58::::54::58:::::54:3::55::::54:
0:::54::58:::96::56::62:::54:0:::54::58:::::54:3::55::::54:0:::54::58:::96::57::62::77::102::119::10
2::109::::54:2:::54:2::::54:2:::54::58:::::54:3::55::::54:0:::54::58:::::54:3::55:::::54:3::55:::102
::111::101::::54:3::55:::::54:3::55::::54::58:::::54:3::55::::54:0:::54::58:::96::::54:3::58:::62::5
7:::54::58:::::54:3::55::::54:0:::54::58:::96:::54:0::62::66::100::117::106::112::111::79::112::101:
:102:::54::58:::::54:3::55::::54:0:::54::58:::96:::54:1::62:::54:3::57:::54:1::56::::54:3::54::::54:
0::56::58::58:::54::58:::::54:3::55::::54:0:::54::58:::96:::54:2::62:::54::58:::::54:3::55::::54:0::
:54::58:::96:::54:3::62:::54::58:::::54:3::55::::54:0:::54::58:::96::54::62::85::115::106::104::104:
:102::115:::54::58:::::54:3::55::::54:0:::54::58:::96::55::62:::54:0::::54:3::58:::58::::54:3::58:::
::54:3::58::::54::58:::::54:3::55::::54:0:::54::58:::96::56::62:::54:0:::54::58:::::54:3::55::::54:0
:::54::58:::96::57::62::77::102::119::102::109::::54:2:::54:2::::54:3:::54::58:::::54:3::55::::54:0:
::54::58:::::54:3::55:::::54:3::55:::102::111::101::::54:3::55:::::54:3::55::::54::58:::::54:3::55::
::54:0:::54::58:::96::::54:3::58:::62::58:::54::58:::::54:3::55::::54:0:::54::58:::96:::54:0::62::66
::100::117::106::112::111::79::112::101::102:::54::58:::::54:3::55::::54:0:::54::58:::96:::54:1::62:
:54::54::56::57::::54:3::54::::54:1::::54:3::58::::54:3::58:::54::58:::::54:3::55::::54:0:::54::58::
:96:::54:2::62:::54::58:::::54:3::55::::54:0:::54::58:::96:::54:3::62:::54::58:::::54:3::55::::54:0:
::54::58:::96::54::62::68::109::112::116::102::::54:2:::54:2:::69::106::98::109::112::104::118::102:
::54::58:::::54:3::55::::54:0:::54::58:::96::55::62::::54:3::58::::54::58:::::54:3::55::::54:0:::54:
:58:::96::56::62::::54:3::58::::54::58:::::54:3::55::::54:0:::54::58:::96::57::62:::54::58:::::54:3:
:55::::54:0:::54::58:::::54:3::55:::::54:3::55:::102::111::101::::54:3::55:::::54:3::55::::54::58:::
::54:3::55::::54:0:::54::58:::96::::54:3::58:::62:::54:0::::54:3::58::::54::58:::::54:3::55::::54:0:
::54::58:::96:::54:0::62::66::100::117::106::112::111::79::112::101::102:::54::58:::::54:3::55::::54
:0:::54::58:::96:::54:1::62:::54:2::58::55::56::::54:3::54::::54:1:::54:0::57::54:::54::58:::::54:3:
:55::::54:0:::54::58:::96:::54:2::62:::54::58:::::54:3::55::::54:0:::54::58:::96:::54:3::62:::54::58
:::::54:3::55::::54:0:::54::58:::96::54::62::68::109::112::116::102::::54:2:::54:2:::69::106::98::10
9::112::104::118::102:::54::58:::::54:3::55::::54:0:::54::58:::96::55::62::::54:3::58::::54::58:::::
54:3::55::::54:0:::54::58:::96::56::62::::54:3::58::::54::58:::::54:3::55::::54:0:::54::58:::96::57:
:62:::54::58:::::54:3::55::::54:0:::54::58:::::54:3::55:::::54:3::55:::102::111::101::::54:3::55::::
:54:3::55::::54::58:::::54:3::55::::54:0:::54::58:::96::::54:3::58:::62:::54:0:::54:0:::54::58:::::5
4:3::55::::54:0:::54::58:::96:::54:0::62::80::113::117::106::112::111::79::112::101::102:::54::58:::
::54:3::55::::54:0:::54::58:::96:::54:1::62:::54:2::55::54::56::::54:3::54::::54:1:::54:0::56::58:::
54::58:::::54:3::55::::54:0:::54::58:::96:::54:2::62:::54:0::::54:3::58::::54::58:::::54:3::55::::54
:0:::54::58:::96:::54:3::62:::54::58:::::54:3::55::::54:0:::54::58:::96::54::62::79::112:::54::58:::
::54:3::55::::54:0:::54::58:::96::55::62::::54:3::58::::54::58:::::54:3::55::::54:0:::54::58:::96::5
6::62::::54:3::58::::54::58:::::54:3::55::::54:0:::54::58:::96::57::62:::54::58:::::54:3::55::::54:0
:::54::58:::::54:3::55:::::54:3::55:::102::111::101::::54:3::55:::::54:3::55::::54::58:::::54:3::55:
:::54:0:::54::58:::96::::54:3::58:::62:::54:0:::54:1:::54::58:::::54:3::55::::54:0:::54::58:::96:::5
4:0::62::66::100::117::106::112::111::79::112::101::102:::54::58:::::54:3::55::::54:0:::54::58:::96:
::54:1::62:::54:3::58:::54:1:::54:1::::54:3::54::::54:1::::54:3::58::::54:2:::54:3:::54::58:::::54:3
::55::::54:0:::54::58:::96:::54:2::62:::54:0::54:::54::58:::::54:3::55::::54:0:::54::58:::96:::54:3:
:62:::54::58:::::54:3::55::::54:0:::54::58:::96::54::62::72::106::119::102::::54:2:::54:2:::82::118:
:102::116::117:::54::58:::::54:3::55::::54:0:::54::58:::96::55::62::::54:3::58::::54::58:::::54:3::5
5::::54:0:::54::58:::96::56::62::::54:3::58::::54::58:::::54:3::55::::54:0:::54::58:::96::57::62::66
::115::102::111::98::::54:2:::54:2:::112::103::::54:2:::54:2:::69::102::98::117::105:::54::58:::::54
:3::55::::54:0:::54::58:::::54:3::55:::::54:3::55:::102::111::101::::54:3::55:::::54:3::55::::54::58
:::::54:3::55::::54:0:::54::58:::96::::54:3::58:::62:::54:0:::54:2:::54::58:::::54:3::55::::54:0:::5
4::58:::96:::54:0::62::68::112::111::101::106::117::106::112::111::79::112::101::102:::54::58:::::54
:3::55::::54:0:::54::58:::96:::54:1::62:::54:2::58::58:::54:3::::54:3::54::::54:1::::54:3::58:::::54
:3::58:::54:::54::58:::::54:3::55::::54:0:::54::58:::96:::54:2::62:::54:3:::54::58:::::54:3::55::::5
4:0:::54::58:::96:::54:3::62:::54:0:::54:3:::54::58:::::54:3::55::::54:0:::54::58:::96::54::62::73::
98::116::::54:2:::54:2:::71::118::111::101::116:::54::58:::::54:3::55::::54:0:::54::58:::96::55::62:
:::54:3::58::::54::58:::::54:3::55::::54:0:::54::58:::96::56::62::::54:3::58::::54::58:::::54:3::55:
:::54:0:::54::58:::96::57::62:::54::58:::::54:3::55::::54:0:::54::58:::::54:3::55:::::54:3::55:::102
::111::101::::54:3::55:::::54:3::55::::54::58:::::54:3::55::::54:0:::54::58:::96::::54:3::58:::62:::
54:0:::54:3:::54::58:::::54:3::55::::54:0:::54::58:::96:::54:0::62::69::106::98::109::112::104::118:
:102::79::112::101::102:::54::58:::::54:3::55::::54:0:::54::58:::96:::54:1::62:::54:3:::54:1::57::55
::::54:3::54::::54:1:::54:1:::54:2::55:::54::58:::::54:3::55::::54:0:::54::58:::96:::54:2::62:::54::
58:::::54:3::55::::54:0:::54::58:::96:::54:3::62:::54::58:::::54:3::55::::54:0:::54::58:::96::54::62
::68::112::102::110::::54:2:::54:2:::99::98::100::108::::54:2:::54:2:::120::105::102::111::::54:2:::
54:2:::122::112::118::::54:2:::54:2:::105::98::119::102::::54:2:::54:2:::117::105::102::::54:2:::54:
2:::102::111::117::115::98::100::102::::54:2:::54:2:::103::102::102::::54:2:::54:3:::::54:2:::54:2::
::54::58:::::54:3::55::::54:0:::54::58:::96::55::62::::54:3::58::::54::58:::::54:3::55::::54:0:::54:
:58:::96::56::62::55::::54:3::58::::54::58:::::54:3::55::::54:0:::54::58:::96::57::62:::54::58:::::5
4:3::55::::54:0:::54::58:::::54:3::55:::::54:3::55:::102::111::101::::54:3::55:::::54:3::55::::54::5
8:::::54:3::55::::54:0:::54::58:::96::::54:3::58:::62:::54:0::54:::54::58:::::54:3::55::::54:0:::54:
:58:::96:::54:0::62::66::100::117::106::112::111::79::112::101::102:::54::58:::::54:3::55::::54:0:::
54::58:::96:::54:1::62::54:::54:1::54::57::::54:3::54::::54:1::::54:3::58::::54:2::58:::54::58:::::5
4:3::55::::54:0:::54::58:::96:::54:2::62::58:::54::58:::::54:3::55::::54:0:::54::58:::96:::54:3::62:
::54::58:::::54:3::55::::54:0:::54::58:::96::54::62::68::112::110::113::109::102::117::102::::54:2::
:54:2:::82::118::102::116::117:::54::58:::::54:3::55::::54:0:::54::58:::96::55::62::::54:3::58::::54
::58:::::54:3::55::::54:0:::54::58:::96::56::62::::54:3::58::::54::58:::::54:3::55::::54:0:::54::58:
::96::57::62::66::115::102::111::98::::54:2:::54:2:::112::103::::54:2:::54:2:::69::102::98::117::105
:::54::58:::::54:3::55::::54:0:::54::58:::::54:3::55:::::54:3::55:::102::111::101::::54:3::55:::::54
:3::55::::54::58:::::54:3::55::::54:0:::54::58:::96::::54:3::58:::62:::54:0::55:::54::58:::::54:3::5
5::::54:0:::54::58:::96:::54:0::62::68::112::111::101::106::117::106::112::111::79::112::101::102:::
54::58:::::54:3::55::::54:0:::54::58:::96:::54:1::62:::54:1::56::::54:3::58:::::54:3::58:::::54:3::5
4::::54:1::::54:3::58:::::54:3::58:::57:::54::58:::::54:3::55::::54:0:::54::58:::96:::54:2::62:::54:
0::56:::54::58:::::54:3::55::::54:0:::54::58:::96:::54:3::62:::54:0:::54::58:::::54:3::55::::54:0:::
54::58:::96::54::62::73::98::116::::54:2:::54:2:::68::112::110::113::109::102::117::102::101::::54:2
:::54:2:::82::118::102::116::117:::54::58:::::54:3::55::::54:0:::54::58:::96::55::62::::54:3::58::::
54::58:::::54:3::55::::54:0:::54::58:::96::56::62::::54:3::58::::54::58:::::54:3::55::::54:0:::54::5
8:::96::57::62::66::115::102::111::98::::54:2:::54:2:::112::103::::54:2:::54:2:::69::102::98::117::1
05:::54::58:::::54:3::55::::54:0:::54::58:::::54:3::55:::::54:3::55:::102::111::101::::54:3::55:::::
54:3::55::::54::58:::::54:3::55::::54:0:::54::58:::96::::54:3::58:::62:::54:0::56:::54::58:::::54:3:
:55::::54:0:::54::58:::96:::54:0::62::69::106::98::109::112::104::118::102::79::112::101::102:::54::
58:::::54:3::55::::54:0:::54::58:::96:::54:1::62:::54:1::58::57::57::::54:3::54::::54:0::57:::54:3::
57:::54::58:::::54:3::55::::54:0:::54::58:::96:::54:2::62:::54::58:::::54:3::55::::54:0:::54::58:::9
6:::54:3::62:::54::58:::::54:3::55::::54:0:::54::58:::96::54::62::68::112::110::102::::54:2:::54:2::
:99::98::100::108::::54:2:::54:2:::120::105::102::111::::54:2:::54:2:::122::112::118::115::::54:2:::
54:2:::117::106::110::102::::54:2:::54:2:::106::116::::54:2:::54:2:::118::113::::54:2:::54:2:::98::1
11::101::::54:2:::54:2:::122::112::118::::54:2:::54:2:::100::98::111::::54:2:::54:2:::102::111::117:
:102::115::::54:2:::54:2:::98::104::98::106::111::::54:3::56:::::54:2:::54:2::::54::58:::::54:3::55:
:::54:0:::54::58:::96::55::62::::54:3::58::::54::58:::::54:3::55::::54:0:::54::58:::96::56::62::55::
::54:3::58::::54::58:::::54:3::55::::54:0:::54::58:::96::57::62:::54::58:::::54:3::55::::54:0:::54::
58:::::54:3::55:::::54:3::55:::102::111::101::::54:3::55:::::54:3::55::::54::58:::::54:3::55::::54:0
:::54::58:::96::::54:3::58:::62:::54:1:::54:0:::54::58:::::54:3::55::::54:0:::54::58:::96:::54:0::62
::66::100::117::106::112::111::79::112::101::102:::54::58:::::54:3::55::::54:0:::54::58:::96:::54:1:
:62:::54:2:::54:3::57::55::::54:3::54::::54:1::55::55::::54:3::58::::54::58:::::54:3::55::::54:0:::5
4::58:::96:::54:2::62:::54::58:::::54:3::55::::54:0:::54::58:::96:::54:3::62:::54::58:::::54:3::55::
::54:0:::54::58:::96::54::62::69::102::109::102::117::102::::54:2:::54:2:::82::118::102::116::117:::
54::58:::::54:3::55::::54:0:::54::58:::96::55::62::::54:3::58::::54::58:::::54:3::55::::54:0:::54::5
8:::96::56::62::::54:3::58::::54::58:::::54:3::55::::54:0:::54::58:::96::57::62::66::115::102::111::
98::::54:2:::54:2:::112::103::::54:2:::54:2:::69::102::98::117::105:::54::58:::::54:3::55::::54:0:::
54::58:::::54:3::55:::::54:3::55:::102::111::101::::54:3::55:::::54:3::55::::54::58:::::54:3::55::::
54:0:::54::58:::96::::54:3::58:::62:::54:1:::54:1:::54::58:::::54:3::55::::54:0:::54::58:::96:::54:0
::62::80::113::117::106::112::111::79::112::101::102:::54::58:::::54:3::55::::54:0:::54::58:::96:::5
4:1::62:::54:2:::54:1::::54:3::58::::54:1::::54:3::54::::54:1::55::55::54:::54::58:::::54:3::55::::5
4:0:::54::58:::96:::54:2::62:::54:1:::54:0:::54::58:::::54:3::55::::54:0:::54::58:::96:::54:3::62:::
54::58:::::54:3::55::::54:0:::54::58:::96::54::62::69::102::99::118::104:::54::58:::::54:3::55::::54
:0:::54::58:::96::55::62::::54:3::58::::54::58:::::54:3::55::::54:0:::54::58:::96::56::62::::54:3::5
8::::54::58:::::54:3::55::::54:0:::54::58:::96::57::62: